0	1	2	3	4	5	6	7
1	4	5	5	7	7	7	-1
2	-1	-1	7	-1	-1	-1	-1
3	-1	-1	-1	-1	-1	-1	-1
5	-1	-1	-1	-1	-1	-1	-1
4	1	1	2	1	1	1	0
